2

3
2 1 1
1 2 2
1 1 0

7
3 6 4 3 2 4 3
2 1 2 3 2 5 2
2 3 4 3 4 2 3
2 4 4 3 4 2 2
4 5 1 3 2 5 4
4 3 2 2 4 5 6
2 5 2 5 6 1 0
